....################.##.....##.##.....##
.#######.########.#######.####.##.###.##
.#####...ABCD.###.#######.####....###...
########.########.EFG.#################.
########.############......###.########.
.#######.##.......###########...####....
########.##.##.##.#.....####..#..###.###
########.##......@#.###.###..###..##.###
.##########.##.##.#.###.##..##.##..#....
.##########.......#.###.###..###..######
.HI.###############.###.####..#..######.
.#####....##....###.###.#####...########
.#####.##.##.##.###.###.######.########.
######..........###.###.############....
...######.##.######.###..........######.
##.###..........###.############.######.
...################.############.###.##.
.####....####.#####.JKLMNOPQRSTU.##.#.##
...##.##.####.####################.#.#.#
##....##.##.....##.##############.#.#.#.